xxxxxxxxxxxxxxxx
x              x
x s  f       s x
x              x
x              x
x              x
x              x
x              x
x              x
x s          s x
x              x
xxxxxxxxxxxxxxxx
